=== Simple Test State Map ===
Format: (MetatileID, Behavior, X, Y)
Map dimensions: 15x15

--- TRAVERSABILITY MAP ---
      0  1  2  3  4  5  6  7  8  9 10 11 12 13 14 
    ------------------------------
 0: . . . . . . . . . # # # # . .
 1: # # . # . . . . . # # ~ ~ . .
 2: # # . . . . . . . ~ ~ ~ ~ ~ .
 3: # # . . . . . . . ~ ~ ~ ~ ~ ~
 4: # # . . . . . . . ~ ~ ~ ~ ~ ~
 5: ~ ~ . . . . ↓ ↓ ↓ ↓ ~ ~ ~ ~ ~
 6: ~ ~ ~ . . . . . . . # # ~ ~ .
 7: ~ ~ ~ ~ . . . P . . # # ~ ~ .
 8: ~ ~ ~ ~ . . . . . . # # # # #
 9: ~ ~ ~ . . . . . . . # # # # #
10: # # # # # # # # . . # # # # #
11: # # # # # # # # . . # # # # #
12: # # # # # # # # . . # # # # #
13: # # # # # # # # . . # # # # #
14: . . . . . . . . . . . . . . .